11111111111111111111111111111111111111111111111111
1P000000000000000000000000000000000000000000000001
1000000C000000000000000000000000000000000000000001
10111111100111111100011111000111100001111000011101
10000000100000000100000001000000010000000100000001
1000C000000000C0000000000000000000000C000100000001
10111111111111111111111111111111111111111111111101
10000000000000000000000000000000000000000000000001
100000000000C0000000000000000000000000C00000000001
10000111111111100111111100011111111111111111000001
10000000000000000100000010000000000000000000000001
1000C0001000000000000C000000000000000000001000C001
11111111111111111111111111111111111111111111111101
10000000000000000000000000000000000000000000000001
10000000000000000000000000000000000000000000000001
10000111111000111111000111111111111111000111111001
10000000000000000000100000000000000000000000001001
1000C0001000100000001000C0000000000001000100001001
11111111111111111111111111111111111111111111111101
10000000000000000000000000000000000000000000000001
100000000000C0000000000000000000000000C00000000001
10000111111111100111111100011111111111111111000001
10000000100000000100000010000000000000000100000001
1000C0000000000000000C000100000000000000001000C001
11111111111111111111111111111111111111111111111101
10000000000000000000000000000000000000000000000001
10000000000000000000000000000000000000000000000001
10000111111000111111000111111111111111000111111001
10000000000000000000000000000000000000100000001001
1000C0001000100000001000C0000000000010001000001001
11111111111111111111111111111111111111111111111101
10000000000000000000000000000000000000000000000001
10000000000000000000000000000000000000000000000001
10000111111000111111000111111111111111000111111001
10000000100000000000000000000000000000100000001001
1000C0000000100000001000C0000000000010001000001001
11111111111111111111111111111111111111111111111101
10000000000000000000000000000000000000000000000001
10000000000000000000000000000000000000000000000001
10000111111000111111000111111111111111000111111001
10000000100010000000100000000000000000100000001001
1000000001000000001000C000100000000000000001000CE1
11111111111111111111111111111111111111111111111111
